{
	"level_image_pattern": "default",
	"level_pattern": [
	    [	 -30, -30, -30, -30, -30, -30, -30, -30,  -30, -30, -30, -30, -30, -30, -30, -30, -30, -30, -30, -30, -30, -30, -30, -30, -30, -30, -30, -30],
		[	  -8, -10, -10, -10, -10, -10, -10, -10,  -10, -10, -10, -10, -10, -10, -10, -10, -10, -10, -10, -10, -10, -10, -10, -10, -10, -10, -10,  -7],
		[	  -9,   1,   1,   1,   1,   1,   1,   1,    1,   1,   1,   1,   1,   1,   1,   1,   1,   1,   1,   1,   1,   1,   1,   1,   1,   1,   1, -11],
		[	  -9,   1, -15, -14, -14, -14, -16,   1,  -15, -14, -14, -16,   1, -15, -16,   1, -15, -14, -14, -16,   1, -15, -14, -14, -14, -16,   1, -11],
		[	  -9,   2, -11, -30, -30, -30,  -9,   2,  -11, -30, -30,  -9,   1, -11,  -9,   2, -11, -30, -30,  -9,   1, -11, -30, -30, -30,  -9,   2, -11],
		[	  -9,   1, -11, -30, -30, -30,  -9,   1,  -11, -30, -30,  -9,   1, -11,  -9,   1, -11, -30, -30,  -9,   1, -11, -30, -30, -30,  -9,   1, -11],
		[	  -9,   1, -12, -10, -10, -10, -13,   1,  -11, -30, -30,  -9,   1, -11,  -9,   1, -11, -30, -30,  -9,   1, -12, -10, -10, -10, -13,   1, -11],
		[	  -9,   1,   1,   1,   1,   1,   1,   1,  -11, -30, -30,  -9,   1, -11,  -9,   1, -11, -30, -30,  -9,   1,   1,   1,   1,   1,   1,   1, -11],
		[	 -30, -14, -14, -14, -14, -14, -16,   1,  -11, -30, -30,  -9,   1, -11,  -9,   1, -11, -30, -30,  -9,   1, -15, -14, -14, -14, -14, -14, -30],
		[	 -30, -10, -10, -10, -10, -10, -13,   1,  -11, -30, -30,  -9,   1, -11,  -9,   1, -11, -30, -30,  -9,   1, -12, -10, -10, -10, -10, -10, -30],
		[	  -9,   1,  1,    1,   1,   1,   1,   1,  -11, -30, -30,  -9,   1, -11,  -9,   1, -11, -30, -30,  -9,   1,   1,   1,   2,   1,   1,   1, -11],
		[	  -9,   1, -15, -14, -14,  -14, -16,  1,  -11, -30, -30,  -9,   1, -11,  -9,   1, -11, -30, -30,  -9,   1, -15, -14, -14, -14, -16,   1, -11],
		[	  -9,   1, -11, -30, -30,  -30,  -9,  1,  -12, -10, -10, -13,   1, -12, -13,   1, -12, -10, -10, -13,   1, -12, -30, -30, -30, -13,   1, -11],
		[	  -9,   1, -11, -30, -30,  -30,  -9,  1,    1,   1,   1,   1,   3,   1,   1,   1,   1,   1,   1,   1,   1,   1, -11, -30,  -9,   1,   1, -11],
		[	  -9,   1, -12, -10, -10,  -10, -13,  1,    1,   1,   1,   1,   1,   1,   1,   1,   1,   1,   1,   1,   1,   1, -11, -30,  -9,   1,   1, -11],
		[	  -9,   1,   1,   1,   1,    1,   1,  1,  -15, -14, -14, -14, -14, -14, -14, -14, -14, -14, -14, -16,   1,   1, -11, -30,  -9,   1,   1, -11],
		[	 -30, -14, -14, -14, -14,  -14, -16,  1,    0,   4,   0,   5,   0,   6,   0,   7,   0,   0, -30,   0,   1,   1, -11, -30,  -9,   2,   1, -11],
		[	 -30, -10, -10, -10, -10,  -10, -13,  1,    0,   0,   0,   0,   0,   0,   0,   0,   0,   0, -30,   0,   1,   1, -11, -30,  -9,   1,   1, -11],
		[	  -9,   1,   1,   1,   1,    1,   1,  1,  -12, -10, -10, -10, -10,   0,   0, -10, -10, -10, -10, -13,   1,   1, -11, -30,  -9,   1,   1, -11],
		[	  -9,   1, -15, -14, -14,  -14, -16,  1,    1,   1,   1,   1,   1,   1,   1,   1,   1,   1,   1,   1,   1,   1, -11, -30,  -9,   1,   1, -11],
		[	  -9,   2, -11, -30, -30,  -30,  -9,  1,    1,   1,   1,   1,   1,   2,   1,   1,   1,   1,   1,   1,   1, -15, -30, -30, -30, -16,   1, -11],
		[	  -9,   1, -12, -10, -10,  -10, -13,  1,  -15, -14, -14, -16,   1, -15, -16,   1, -15, -14, -14, -16,   1, -12, -10, -10, -10, -13,   1, -11],
		[	  -9,   1,   1,   1,   1,    1,   1,  1,  -11, -30, -30,  -9,   1, -11,  -9,   1, -11, -30, -30,  -9,   1,   1,   1,   1,   1,   1,   1, -11],
		[	 -30, -14, -14, -14, -14,  -14, -16,  1,  -11, -30, -30,  -9,   1, -11,  -9,   1, -11, -30, -30,  -9,   1, -15, -14, -14, -14, -14, -14, -30],
		[	 -30, -10, -10, -10, -10,  -10, -13,  1,  -11, -30, -30,  -9,   1, -11,  -9,   1, -11, -30, -30,  -9,   1, -12, -10, -10, -10, -10, -10, -30],
		[	  -9,   1,   1,   2,   1,    1,   1,  1,  -11, -30, -30,  -9,   2, -11,  -9,   1, -11, -30, -30,  -9,   1,   1,   1,   1,   2,   1,   1, -11],
		[	  -9,   1, -15, -14, -14,  -14, -16,  1,  -11, -30, -30,  -9,   1, -11,  -9,   1, -11, -30, -30,  -9,   1, -15, -14, -14, -14, -16,   1, -11],
		[	  -9,   1, -11, -30, -30,  -30,  -9,  1,  -11, -30, -30,  -9,   1, -11,  -9,   1, -11, -30, -30,  -9,   1, -11, -30, -30, -30,  -9,   1, -11],
		[	  -9,   1, -11, -30, -30,  -30,  -9,  1,  -11, -30, -30,  -9,   1, -11,  -9,   1, -11, -30, -30,  -9,   1, -11, -30, -30, -30,  -9,   1, -11],
		[	  -9,   1, -12, -10, -10,  -10, -13,  1,  -12, -10, -10, -13,   1, -12, -13,   1, -12, -10, -10, -13,   1, -12, -10, -10, -10, -13,   1, -11],
		[	  -9,   1,   1,   2,   1,    1,   1,  1,    1,   1,   1,   1,   1,   1,   1,   1,   1,   1,   1,   1,   1,   1,   1,   1,   1,   1,   1, -11],
		[	 -18, -14, -14, -14, -14,  -14, -14, -14, -14, -14, -14, -14, -14, -14, -14, -14, -14, -14, -14, -14, -14, -14, -14, -14, -14, -14, -14, -17]
	],
	"fantasmas": ["rojo", "cian", "rosado", "naranja"]
}
